%%%%%%%%%%%%%%%%%%%%%%%%%
%.. P  ....  G   ....   %
%..  ...  ...  ... G... %
%..  ...  ...  ...  ... %
%.. G  ....   G  ....  o%
%%%%%%%%%%%%%%%%%%%%%%%%%
