%%%%%%%%%%%%%%%%%%%%%%%
% P                   %
% .... %%%o.%%%% .... %
% .... %       % .... %
% .... % G..G  % .... %
% .... %       % .... %
%      %%%..%%%%      %
%      %              %
%      .   %%...%%    %
%      %              %
%%%%%%%%%%%%%%%%%%%%%%%