%%%%%%%%%%%%%%%%%%%%%%%
% P                   %
% .... %%%o%%%%% .... %
% %%%% %       % %%%% %
% .%%. . G..G  . %..% %
% .... %       % .... %
%      %%%..%%%%      %
%      %  %           %
%      .    %         %
%      %      %%      %
%%%%%%%%%%%%%%%%%%%%%%%