%%%%%%%%%%%%%%%%%%%%%%%
% P                   %
%  .. % .        % .. %
%  .. %  .     G % .. %
%  .. %   .      % .. %
%  .. %    .     % .. %
%     %     .    %    %
%     %      .   %    %
%     .  G    .  %    %
%     %        . %    %
%                     %
%%%%%%%%%%%%%%%%%%%%%%%