%%%%%%%%%%%%%%%%%%%%
%......%G  G%......%
%..%...%%  %%...%..%
%%%%%..........%%%%%
%..................%
%........P.........%
%%%%%%%%%%%%%%%%%%%%
