%%%%%%
% . .%
%.G. %
%%.  %
%. . %
%   %%
%  . %
% .  %
%P . %
%%%%%%
