%%%%%%%%%%%%%%%%
%..............%
%%%%%..%%%%%...%
%.%%........%%%%
%%%.....%.....%%
%.......%%%%..%%
%...%%%.%.....%%
%%%..%.........%
%.........%..%.%
%...%.%.%......%
%..........%...%
%%%.o....o...%.%
%%....%.....%..%
%%%.%%.o%.....%%
%......%%%%.%..%
%....%.........%
%o%%....o%..%..%
%...o%%....%P%%%
%%%%...........%
%..%%%%%%......%
%..%..%........%
%.....%%.%..G..%
%....%%G.....%%%
%%......%......%
%...o.o...%....%
%%%%%%%%%%%%%%%%
