%%%%%%%%%%%%
%..........%
%..%%......%
%.....%%%.o%
%%%%%%%%..%%
%%%o.G...%%%
%.........%%
%...%.o%..%%
%%....o...%%
%..........%
%....%%..%%%
%.....o...%%
%...%%.%%..%
%.G........%
%...%o.....%
%%%%....%o.%
%%%%%.%....%
%........oG%
%...%......%
%.%........%
%.%%..%.%..%
%%%..%....%%
%........%%%
%%.P%...%.%%
%......o..%%
%%.o.....%%%
%.....o..%%%
%.......%%%%
%.....%....%
%...G......%
%...%o..o..%
%....%%%%%%%
%...o..%%.%%
%%%%%%%%%%%%
